111111111111111111111111111111
1E0000000010000C00000C000000C1
101001010010000010100100000111
101001001010101000100100000001
1P0000000C00C00000000000000001
111111111111111111111111111111